11111111111111111111111111
1C0000000000110M100C0000C1
1C00000000001100100C0000C1
1C00000000001100100C0000C1
1C00000111001100100C0000C1
1C000000M1001100100C0000C1
1C00000111001100100C0000C1
1C000000M0000000100C0000C1
1C000000M0001100100C0000C1
1C00000000001100100C0000C1
1C00000000001100000C0000C1
1C00000000001100100C0000C1
1C00000000001100100C0000C1
1C00000000001100100C0000C1
1C00000000001100100C0000C1
1C00000000001100100C0000C1
100100C0000C1100100C0000C1
1C00000000000000100C0000C1
100100C0000C0000100C0000C1
1C00000000000000100C0000C1
100100C0000C000E100C0000C1
1C00000000000000100C0000C1
1P00110000001100100C0000C1
11111111111111111111111111