11111111111111111111111111
1C00000000001100100C0000C1
1C0000E000001000100C0000C1
1C00000000000000000C0000C1
1C0P000000001000000C0000C1
11111111111111111111111111