111111111111111111111111111111111111111
100M0000M0000M00001E1000M0000M0000M0001
101111011110111100101001111011110111101
101111C1111011110010100111101111C111101
10111101111C111100101001111C11110111101
101111011110111100101001111011110111101
100000000000000000000000000000000000001
100000000000000000000000000000000000001
100M0000M0000M0000000000M0000M0000M0001
101111011110111100101001111011110111101
10111101111C111100101001111C11110111101
101111C1111011110010100111101111C111101
101111011110111100101001111011110111101
1000000000000000001P1000000000000000001
111111111111111111111111111111111111111